

C         16,36,84 



			NO img/wall/n.xpm  
SO img/wall/s.xpm

WE img/wall/w.xpm



	F 	145,154,52
	EA img/wall/e.xpm
	



 11111111111111111
1000001000100000001
1000000000000011101
100000000000001 101
1000N00000110011101
1010000000000000001
1111111111111111111