	F 	48,78,52



C         16,36,84


			NO maps/08.xpm 
SO   maps/10.xpm


WE maps/09.xpm


	EA maps/11.xpm




         111111111111111111111111
         1000000000110000000000001
        1001000001110000000000001
        10010000000000000000000011
1111111110110000011100000000000001
1000000000000000011101111011111111
11110111111111011100000010001
11110111111111011101010010001
11000000110101011100000010001
10000000000000001100000010001
10000000000000001100000100001
11000001110101011111011110N01
11110111 1110101 101111010001
11111111 1111111 111111111111


11111
100001
1N001
10001 
11111
