	F 	48,78,52



C         16,36,84


			NO maps/08.xpm 
SO   maps/10.xpm


WE maps/09.xpm


	EA maps/11.xpm

         1111111111111111111111111
         1000000000110000000000001
        10010000011100000000000001
        10010000000000000000000011
1111111110110000011100000000000001
100000000000000001112111121111111
11110111111111011100000010001
11110111111111011121010010001
11000000110101011100000010001
10000000000000001100000010001
10000000000000001100000000001
11000001110101011111011110N01
11110111 1110101 101111010001
11111111 1111111 111111111111

11111111111111111111111111111111111111111111
10000000000000000000000000000000000000000001
10000000000000000000000000000000000000000001
10000000000000111000111100000000000000000001
10000000000000100000000100000000000000000001
1000000000000010000000010000000000000000000111111111
1000000000000010000000010000000000000000000000000001
100000000000001000N000010000000000000000000111111111
10000000000000100000000100000000000000000001
10000000001000111111111100001000110000000001
10000000011000100000000100011000000000000001
10000000011000001000000010011000000000010001
10000000110000000000000000110000000000000001
10000000000000000000000001100000000000000001
10000000000000000000100001000000000000000001
10011000000000000000000000000000000000000001
11111111111111111111111111111111111111111111


111111
100001
1N0001
100001
100001
100001
100001
100001
100001
100001
100001
111111