	F 	119,221,119



C         167,199,231


			NO maps/astronaut.xpm
SO   maps/tree_1.xpm


WE maps/00.xpm


	EA maps/01.xpm

1111111111111111111111111
1000000000110000000000001
10110N0001110000000000001
1001000000000000000000001
1011000001110000000000001
1111111111111111111111111

