	F 	48,78,52



C         16,36,84


			NO img/wall/08.xpm 
SO   img/wall/10.xpm


WE img/wall/09.xpm


	EA img/wall/11.xpm



         1111111111111111111111111
         1000000000110000000000001
        10010000011100000000000001
        10010000000000000200000011
1111111110110000011100000000000001
100000000000000001112111121111111
11110111111111011100000010001
11112111111111011101010010001
11000000110101011100000010001
10000000000000001100000010001
10000000000000001100000000001
11000001110101011111211110N01
11110111 1110101 101111010001
11111111 1111111 111111111111



