	F 	119,221,119



C         167,199,231


			NO maps/01.xpm
SO   maps/01.xpm


WE maps/01.xpm


	EA maps/01.xpm


        1111111111111111111111111
        1000000000110000000000001
        1011000001110000000000001
        10010S0000000000000000001
111111111011000001110000000000001
100000000011000001110111111111111
11110111111111011100000010001
11110111111111011101010010001
11000000110101011100000010001
10000000000000001100000010001
10000000000000001100000010001
11000001110101011111011110001
11110111 1110101 101111010001
11111111 1111111 111111111111
