	F 	119,221,119



C         167,199,231


			NO maps/tree_1.xpm
SO   maps/wall_gr.xpm


WE maps/astronaut.xpm


	EA maps/01.xpm




         111111111111111111111111
        1000000000110000000000001
        1011000001110000000000001
        1001000000000000000000001
111111111011000001110000000000001
10000000001100000111011110111111
11110111111111011100000010001
11110111111111011101010010001
11000000110101011100000010001
10000000000000001100000010001
10000000000000001100000100001
11000001110101011111011110N011
11110111 1110101 101111010001
11111111 1111111 111111111111



11111
10001
1N001
10001 
11111