	F 	128,8,92

C         242,154,84



			NO img/wall/08.xpm 
SO   img/wall/10.xpm


WE img/wall/09.xpm


	EA img/wall/11.xpm



111111111111111111111111111111111111111111111111111111111111111111111111111111111111111111111111111111111111111111111111111111111111111111111111111111111111111111111111111111111111111111111111111111111111111111111111111111111111111111111111111111111111111111111111111111111111111111111111111111111111111111111111111111111111111111111111111111111111111111111111111111111111111111111111111111111111111111111111111111111111111111111111111111111111111111111111111111111111111111111111111111111111111111111111111111111111111111111111111111111111111111111111111111111111111111111111111111111111111111111111111111111111111111111111111111111111111111111111111111111111111111111111111111111111111111111111111111111111111111111111111111111111111111111111111111111111111111111111111111111111111111111111111111111111111111111111111111111111111111111111111111111111111111111111111111111111111111111111111111111111111111111111111111111111111111111111111111111111111111111111111111111111111111111111111111111111111111111111111111111111111111111111111111111111111111111111111111111111111111111111111111111111111111111111111111111111111111111111111111111111111111111111111111111111111111111111111111111111111111111111111111111111111111111111111111111111111111111111111111111111111111111111111111111111111111111111111111111111111111111111111111111111111111111111111111111111111111111111111111111111111111111111111111111111111111111111111111111111111111111111111111111111111111111111111111111111111111111111111111111111111111111111111111111111111111111111111111111111111111111111111111111111111111111111111111111111111111111111111111111111111111111111111111111111111111111111111111111111111111
100000000000000000000000000000000000000000011000000000000000000000000000000000000000000110000000000000000000000000000000000000000001100000000000000000000000000000000000000000011000000000000000000000000000000000000000000110000000000000000000000000000000000000000001100000000000000000000000000000000000000000011000000000000000000000000000000000000000000110000000000000000000000000000000000000000001100000000000000000000000000000000000000000011000000000000000000000000000000000000000000110000000000000000000000000000000000000000001100000000000000000000000000000000000000000011000000000000000000000000000000000000000000110000000000000000000000000000000000000000001100000000000000000000000000000000000000000011000000000000000000000000000000000000000000110000000000000000000000000000000000000000001100000000000000000000000000000000000000000011000000000000000000000000000000000000000000110000000000000000000000000000000000000000001100000000000000000000000000000000000000000011000000000000000000000000000000000000000000110000000000000000000000000000000000000000001100000000000000000000000000000000000000000011000000000000000000000000000000000000000000110000000000000000000000000000000000000000001100000000000000000000000000000000000000000011000000000000000000000000000000000000000000110000000000000000000000000000000000000000001100000000000000000000000000000000000000000011000000000000000000000000000000000000000000110000000000000000000000000000000000000000001100000000000000000000000000000000000000000011000000000000000000000000000000000000000000110000000000000000000000000000000000000000001100000000000000000000000000000000000000000011000000000000000000000000000000000000000000111
100000000000000000000000000000000000000000000000000000000000000000000000000000000000000000000000000000000000000000000000000000000000000000000000000000000000000000000000000000000000000000000000000000000000000000000000000000000000000000000000000000000000000000000000000000000000000000000000000000000000000000000000000000000000000000000000000000000000000000000000000000000000000000000000000000000000000000000000000000000000000000000000000000000000000000000000000000000000000000000000000000000000000000000000000000000000000000000000000000000000000000000000000000000000000000000000000000000000000000000000000000000000000000000000000000000000000000000000000000000000000000000000000000000000000000000000000000000000000000000000000000000000000000000000000000000000000000000000000000000000000000000000000000000000000000000000000000000000000000000000000000000000000000000000000000000000000000000000000000000000000000000000000000000000000000000000000000000000000000000000000000000000000000000000000000000000000000000000000000000000000000000000000000000000000000000000000000000000000000000000000000000000000000000000000000000000000000000000000000000000000000000000000000000000000000000000000000000000000000000000000000000000000000000000000000000000000000000000000000000000000000000000000000000000000000000000000000000000000000000000000000000000000000000000000000000000000000000000000000000000000000000000000000000000000000000000000000000000000000000000000000000000000000000000000000000000000000000000000000000000000000000000000000000000000000000000000000000000000000000000000000000000000000000000000000000000000000000000000000000000000000000000000000000000000000000000000000000000000001
100000000000001110001111000000000000000000011000000000000011100011110000000000000000000110000000000000111000111100000000000000000001100000000000001110001111000000000000000000011000000000000011100011110000000000000000000110000000000000111000111100000000000000000001100000000000001110001111000000000000000000011000000000000011100011110000000000000000000110000000000000111000111100000000000000000001100000000000001110001111000000000000000000011000000000000011100011110000000000000000000110000000000000111000111100000000000000000001100000000000001110001111000000000000000000011000000000000011100011110000000000000000000110000000000000111000111100000000000000000001100000000000001110001111000000000000000000011000000000000011100011110000000000000000000110000000000000111000111100000000000000000001100000000000001110001111000000000000000000011000000000000011100011110000000000000000000110000000000000111000111100000000000000000001100000000000001110001111000000000000000000011000000000000011100011110000000000000000000110000000000000111000111100000000000000000001100000000000001110001111000000000000000000011000000000000011100011110000000000000000000110000000000000111000111100000000000000000001100000000000001110001111000000000000000000011000000000000011100011110000000000000000000110000000000000111000111100000000000000000001100000000000001110001111000000000000000000011000000000000011100011110000000000000000000110000000000000111000111100000000000000000001100000000000001110001111000000000000000000011000000000000011100011110000000000000000000110000000000000111000111100000000000000000001100000000000001110001111000000000000000000011000000000000011100011110000000000000000000111
100000000000001000000001000000000000000000011000000000000010000000010000000000000000000110000000000000100000000100000000000000000001100000000000001000000001000000000000000000011000000000000010000000010000000000000000000110000000000000100000000100000000000000000001100000000000001000000001000000000000000000011000000000000010000000010000000000000000000110000000000000100000000100000000000000000001100000000000001000000001000000000000000000011000000000000010000000010000000000000000000110000000000000100000000100000000000000000001100000000000001000000001000000000000000000011000000000000010000000010000000000000000000110000000000000100000000100000000000000000001100000000000001000000001000000000000000000011000000000000010000000010000000000000000000110000000000000100000000100000000000000000001100000000000001000000001000000000000000000011000000000000010000000010000000000000000000110000000000000100000000100000000000000000001100000000000001000000001000000000000000000011000000000000010000000010000000000000000000110000000000000100000000100000000000000000001100000000000001000000001000000000000000000011000000000000010000000010000000000000000000110000000000000100000000100000000000000000001100000000000001000000001000000000000000000011000000000000010000000010000000000000000000110000000000000100000000100000000000000000001100000000000001000000001000000000000000000011000000000000010000000010000000000000000000110000000000000100000000100000000000000000001100000000000001000000001000000000000000000011000000000000010000000010000000000000000000110000000000000100000000100000000000000000001100000000000001000000001000000000000000000011000000000000010000000010000000000000000000111
100000000000001000000001000000000000000000011000000000000010000000010000000000000000000110000000000000100000000100000000000000000001100000000000001000000001000000000000000000011000000000000010000000010000000000000000000110000000000000100000000100000000000000000001100000000000001000000001000000000000000000011000000000000010000000010000000000000000000110000000000000100000000100000000000000000001100000000000001000000001000000000000000000011000000000000010000000010000000000000000000110000000000000100000000100000000000000000001100000000000001000000001000000000000000000011000000000000010000000010000000000000000000110000000000000100000000100000000000000000001100000000000001000000001000000000000000000011000000000000010000000010000000000000000000110000000000000100000000100000000000000000001100000000000001000000001000000000000000000011000000000000010000000010000000000000000000110000000000000100000000100000000000000000001100000000000001000000001000000000000000000011000000000000010000000010000000000000000000110000000000000100000000100000000000000000001100000000000001000000001000000000000000000011000000000000010000000010000000000000000000110000000000000100000000100000000000000000001100000000000001000000001000000000000000000011000000000000010000000010000000000000000000110000000000000100000000100000000000000000001100000000000001000000001000000000000000000011000000000000010000000010000000000000000000110000000000000100000000100000000000000000001100000000000001000000001000000000000000000011000000000000010000000010000000000000000000110000000000000100000000100000000000000000001100000000000001000000001000000000000000000011000000000000010000000010000000000000000000111
100000000000001000000001000000000000000000011000000000000010000000010000000000000000000110000000000000100000000100000000000000000001100000000000001000000001000000000000000000011000000000000010000000010000000000000000000110000000000000100000000100000000000000000001100000000000001000000001000000000000000000011000000000000010000000010000000000000000000110000000000000100000000100000000000000000001100000000000001000000001000000000000000000011000000000000010000000010000000000000000000110000000000000100000000100000000000000000001100000000000001000000001000000000000000000011000000000000010000000010000000000000000000110000000000000100000000100000000000000000001100000000000001000000001000000000000000000011000000000000010000000010000000000000000000110000000000000100000000100000000000000000001100000000000001000000001000000000000000000011000000000000010000000010000000000000000000110000000000000100000000100000000000000000001100000000000001000000001000000000000000000011000000000000010000000010000000000000000000110000000000000100000000100000000000000000001100000000000001000000001000000000000000000011000000000000010000000010000000000000000000110000000000000100000000100000000000000000001100000000000001000000001000000000000000000011000000000000010000000010000000000000000000110000000000000100000000100000000000000000001100000000000001000000001000000000000000000011000000000000010000000010000000000000000000110000000000000100000000100000000000000000001100000000000001000000001000000000000000000011000000000000010000000010000000000000000000110000000000000100000000100000000000000000001100000000000001000000001000000000000000000011000000000000010000000010000000000000000000111
100000000000001000S00001000000000000000000011000000000000010000000010000000000000000000110000000000000100000000100000000000000000001100000000000001000000001000000000000000000011000000000000010000000010000000000000000000110000000000000100000000100000000000000000001100000000000001000000001000000000000000000011000000000000010000000010000000000000000000110000000000000100000000100000000000000000001100000000000001000000001000000000000000000011000000000000010000000010000000000000000000110000000000000100000000100000000000000000001100000000000001000000001000000000000000000011000000000000010000000010000000000000000000110000000000000100000000100000000000000000001100000000000001000000001000000000000000000011000000000000010000000010000000000000000000110000000000000100000000100000000000000000001100000000000001000000001000000000000000000011000000000000010000000010000000000000000000110000000000000100000000100000000000000000001100000000000001000000001000000000000000000011000000000000010000000010000000000000000000110000000000000100000000100000000000000000001100000000000001000000001000000000000000000011000000000000010000000010000000000000000000110000000000000100000000100000000000000000001100000000000001000000001000000000000000000011000000000000010000000010000000000000000000110000000000000100000000100000000000000000001100000000000001000000001000000000000000000011000000000000010000000010000000000000000000110000000000000100000000100000000000000000001100000000000001000000001000000000000000000011000000000000010000000010000000000000000000110000000000000100000000100000000000000000001100000000000001000000001000000000000000000011000000000000010000000010000000000000000000111
100000000000001000000001000000000000000000011000000000000010000000010000000000000000000110000000000000100000000100000000000000000001100000000000001000000001000000000000000000011000000000000010000000010000000000000000000110000000000000100000000100000000000000000001100000000000001000000001000000000000000000011000000000000010000000010000000000000000000110000000000000100000000100000000000000000001100000000000001000000001000000000000000000011000000000000010000000010000000000000000000110000000000000100000000100000000000000000001100000000000001000000001000000000000000000011000000000000010000000010000000000000000000110000000000000100000000100000000000000000001100000000000001000000001000000000000000000011000000000000010000000010000000000000000000110000000000000100000000100000000000000000001100000000000001000000001000000000000000000011000000000000010000000010000000000000000000110000000000000100000000100000000000000000001100000000000001000000001000000000000000000011000000000000010000000010000000000000000000110000000000000100000000100000000000000000001100000000000001000000001000000000000000000011000000000000010000000010000000000000000000110000000000000100000000100000000000000000001100000000000001000000001000000000000000000011000000000000010000000010000000000000000000110000000000000100000000100000000000000000001100000000000001000000001000000000000000000011000000000000010000000010000000000000000000110000000000000100000000100000000000000000001100000000000001000000001000000000000000000011000000000000010000000010000000000000000000110000000000000100000000100000000000000000001100000000000001000000001000000000000000000011000000000000010000000010000000000000000000111
100000000010001111111111000010001100000000011000000000100011111111110000100011000000000110000000001000111111111100001000110000000001100000000010001111111111000010001100000000011000000000100011111111110000100011000000000110000000001000111111111100001000110000000001100000000010001111111111000010001100000000011000000000100011111111110000100011000000000110000000001000111111111100001000110000000001100000000010001111111111000010001100000000011000000000100011111111110000100011000000000110000000001000111111111100001000110000000001100000000010001111111111000010001100000000011000000000100011111111110000100011000000000110000000001000111111111100001000110000000001100000000010001111111111000010001100000000011000000000100011111111110000100011000000000110000000001000111111111100001000110000000001100000000010001111111111000010001100000000011000000000100011111111110000100011000000000110000000001000111111111100001000110000000001100000000010001111111111000010001100000000011000000000100011111111110000100011000000000110000000001000111111111100001000110000000001100000000010001111111111000010001100000000011000000000100011111111110000100011000000000110000000001000111111111100001000110000000001100000000010001111111111000010001100000000011000000000100011111111110000100011000000000110000000001000111111111100001000110000000001100000000010001111111111000010001100000000011000000000100011111111110000100011000000000110000000001000111111111100001000110000000001100000000010001111111111000010001100000000011000000000100011111111110000100011000000000110000000001000111111111100001000110000000001100000000010001111111111000010001100000000011000000000100011111111110000100011000000000111
100000000110001000000001000110000000000000011000000001100010000000010001100000000000000110000000011000100000000100011000000000000001100000000110001000000001000110000000000000011000000001100010000000010001100000000000000110000000011000100000000100011000000000000001100000000110001000000001000110000000000000011000000001100010000000010001100000000000000110000000011000100000000100011000000000000001100000000110001000000001000110000000000000011000000001100010000000010001100000000000000110000000011000100000000100011000000000000001100000000110001000000001000110000000000000011000000001100010000000010001100000000000000110000000011000100000000100011000000000000001100000000110001000000001000110000000000000011000000001100010000000010001100000000000000110000000011000100000000100011000000000000001100000000110001000000001000110000000000000011000000001100010000000010001100000000000000110000000011000100000000100011000000000000001100000000110001000000001000110000000000000011000000001100010000000010001100000000000000110000000011000100000000100011000000000000001100000000110001000000001000110000000000000011000000001100010000000010001100000000000000110000000011000100000000100011000000000000001100000000110001000000001000110000000000000011000000001100010000000010001100000000000000110000000011000100000000100011000000000000001100000000110001000000001000110000000000000011000000001100010000000010001100000000000000110000000011000100000000100011000000000000001100000000110001000000001000110000000000000011000000001100010000000010001100000000000000110000000011000100000000100011000000000000001100000000110001000000001000110000000000000011000000001100010000000010001100000000000000111
100000000110000010000000100110000000000100011000000001100000100000001001100000000001000110000000011000001000000010011000000000010001100000000110000010000000100110000000000100011000000001100000100000001001100000000001000110000000011000001000000010011000000000010001100000000110000010000000100110000000000100011000000001100000100000001001100000000001000110000000011000001000000010011000000000010001100000000110000010000000100110000000000100011000000001100000100000001001100000000001000110000000011000001000000010011000000000010001100000000110000010000000100110000000000100011000000001100000100000001001100000000001000110000000011000001000000010011000000000010001100000000110000010000000100110000000000100011000000001100000100000001001100000000001000110000000011000001000000010011000000000010001100000000110000010000000100110000000000100011000000001100000100000001001100000000001000110000000011000001000000010011000000000010001100000000110000010000000100110000000000100011000000001100000100000001001100000000001000110000000011000001000000010011000000000010001100000000110000010000000100110000000000100011000000001100000100000001001100000000001000110000000011000001000000010011000000000010001100000000110000010000000100110000000000100011000000001100000100000001001100000000001000110000000011000001000000010011000000000010001100000000110000010000000100110000000000100011000000001100000100000001001100000000001000110000000011000001000000010011000000000010001100000000110000010000000100110000000000100011000000001100000100000001001100000000001000110000000011000001000000010011000000000010001100000000110000010000000100110000000000100011000000001100000100000001001100000000001000111
100000001100000000000000001100000000000000011000000011000000000000000011000000000000000110000000110000000000000000110000000000000001100000001100000000000000001100000000000000011000000011000000000000000011000000000000000110000000110000000000000000110000000000000001100000001100000000000000001100000000000000011000000011000000000000000011000000000000000110000000110000000000000000110000000000000001100000001100000000000000001100000000000000011000000011000000000000000011000000000000000110000000110000000000000000110000000000000001100000001100000000000000001100000000000000011000000011000000000000000011000000000000000110000000110000000000000000110000000000000001100000001100000000000000001100000000000000011000000011000000000000000011000000000000000110000000110000000000000000110000000000000001100000001100000000000000001100000000000000011000000011000000000000000011000000000000000110000000110000000000000000110000000000000001100000001100000000000000001100000000000000011000000011000000000000000011000000000000000110000000110000000000000000110000000000000001100000001100000000000000001100000000000000011000000011000000000000000011000000000000000110000000110000000000000000110000000000000001100000001100000000000000001100000000000000011000000011000000000000000011000000000000000110000000110000000000000000110000000000000001100000001100000000000000001100000000000000011000000011000000000000000011000000000000000110000000110000000000000000110000000000000001100000001100000000000000001100000000000000011000000011000000000000000011000000000000000110000000110000000000000000110000000000000001100000001100000000000000001100000000000000011000000011000000000000000011000000000000000111
100000000000000000000000011000000000000000011000000000000000000000000110000000000000000110000000000000000000000001100000000000000001100000000000000000000000011000000000000000011000000000000000000000000110000000000000000110000000000000000000000001100000000000000001100000000000000000000000011000000000000000011000000000000000000000000110000000000000000110000000000000000000000001100000000000000001100000000000000000000000011000000000000000011000000000000000000000000110000000000000000110000000000000000000000001100000000000000001100000000000000000000000011000000000000000011000000000000000000000000110000000000000000110000000000000000000000001100000000000000001100000000000000000000000011000000000000000011000000000000000000000000110000000000000000110000000000000000000000001100000000000000001100000000000000000000000011000000000000000011000000000000000000000000110000000000000000110000000000000000000000001100000000000000001100000000000000000000000011000000000000000011000000000000000000000000110000000000000000110000000000000000000000001100000000000000001100000000000000000000000011000000000000000011000000000000000000000000110000000000000000110000000000000000000000001100000000000000001100000000000000000000000011000000000000000011000000000000000000000000110000000000000000110000000000000000000000001100000000000000001100000000000000000000000011000000000000000011000000000000000000000000110000000000000000110000000000000000000000001100000000000000001100000000000000000000000011000000000000000011000000000000000000000000110000000000000000110000000000000000000000001100000000000000001100000000000000000000000011000000000000000011000000000000000000000000110000000000000000111
100000000000000000001000010000000000000000011000000000000000000010000100000000000000000110000000000000000000100001000000000000000001100000000000000000001000010000000000000000011000000000000000000010000100000000000000000110000000000000000000100001000000000000000001100000000000000000001000010000000000000000011000000000000000000010000100000000000000000110000000000000000000100001000000000000000001100000000000000000001000010000000000000000011000000000000000000010000100000000000000000110000000000000000000100001000000000000000001100000000000000000001000010000000000000000011000000000000000000010000100000000000000000110000000000000000000100001000000000000000001100000000000000000001000010000000000000000011000000000000000000010000100000000000000000110000000000000000000100001000000000000000001100000000000000000001000010000000000000000011000000000000000000010000100000000000000000110000000000000000000100001000000000000000001100000000000000000001000010000000000000000011000000000000000000010000100000000000000000110000000000000000000100001000000000000000001100000000000000000001000010000000000000000011000000000000000000010000100000000000000000110000000000000000000100001000000000000000001100000000000000000001000010000000000000000011000000000000000000010000100000000000000000110000000000000000000100001000000000000000001100000000000000000001000010000000000000000011000000000000000000010000100000000000000000110000000000000000000100001000000000000000001100000000000000000001000010000000000000000011000000000000000000010000100000000000000000110000000000000000000100001000000000000000001100000000000000000001000010000000000000000011000000000000000000010000100000000000000000111
100110000000000000000000000000000000000000011001100000000000000000000000000000000000000110011000000000000000000000000000000000000001100110000000000000000000000000000000000000011001100000000000000000000000000000000000000110011000000000000000000000000000000000000001100110000000000000000000000000000000000000011001100000000000000000000000000000000000000110011000000000000000000000000000000000000001100110000000000000000000000000000000000000011001100000000000000000000000000000000000000110011000000000000000000000000000000000000001100110000000000000000000000000000000000000011001100000000000000000000000000000000000000110011000000000000000000000000000000000000001100110000000000000000000000000000000000000011001100000000000000000000000000000000000000110011000000000000000000000000000000000000001100110000000000000000000000000000000000000011001100000000000000000000000000000000000000110011000000000000000000000000000000000000001100110000000000000000000000000000000000000011001100000000000000000000000000000000000000110011000000000000000000000000000000000000001100110000000000000000000000000000000000000011001100000000000000000000000000000000000000110011000000000000000000000000000000000000001100110000000000000000000000000000000000000011001100000000000000000000000000000000000000110011000000000000000000000000000000000000001100110000000000000000000000000000000000000011001100000000000000000000000000000000000000110011000000000000000000000000000000000000001100110000000000000000000000000000000000000011001100000000000000000000000000000000000000110011000000000000000000000000000000000000001100110000000000000000000000000000000000000011001100000000000000000000000000000000000000111
111111111111111111111111111111111111111111111111111111111111111111111111111111111111111111111111111111111111111111111111111111111111111111111111111111111111111111111111111111111111111111111111111111111111111111111111111111111111111111111111111111111111111111111111111111111111111111111111111111111111111111111111111111111111111111111111111111111111111111111111111111111111111111111111111111111111111111111111111111111111111111111111111111111111111111111111111111111111111111111111111111111111111111111111111111111111111111111111111111111111111111111111111111111111111111111111111111111111111111111111111111111111111111111111111111111111111111111111111111111111111111111111111111111111111111111111111111111111111111111111111111111111111111111111111111111111111111111111111111111111111111111111111111111111111111111111111111111111111111111111111111111111111111111111111111111111111111111111111111111111111111111111111111111111111111111111111111111111111111111111111111111111111111111111111111111111111111111111111111111111111111111111111111111111111111111111111111111111111111111111111111111111111111111111111111111111111111111111111111111111111111111111111111111111111111111111111111111111111111111111111111111111111111111111111111111111111111111111111111111111111111111111111111111111111111111111111111111111111111111111111111111111111111111111111111111111111111111111111111111111111111111111111111111111111111111111111111111111111111111111111111111111111111111111111111111111111111111111111111111111111111111111111111111111111111111111111111111111111111111111111111111111111111111111111111111111111111111111111111111111111111111111111111111111111111111111111111111111111111



