

C         16,36,84 



			NO img/wall/n.xpm  
SO img/wall/s.xpm

WE img/wall/w.xpm



	F 	145,154,52
	EA img/wall/e.xpm
	

 11111111111111111
1000001000000000001
1000000000100000001
1000000001 10000001
1000E00000100000001
1210000000000000001
1111111111111111111
