


C        16,36,84


			NO maps/tree_1.xpm
SO   maps/tree_1.xpm


WE maps/wall_gr.xpm


	F 	00,00,52
	EA maps/tree_1.xpm


1111111111111111111
1000001000100000001
1000000000000000001
1000000000000000001
1000N00000110000001
1010000000000000001
1111111111111111111

11111111111111111111111111111111111111111111
10000000000000000000000000000000000000000001
10000000000000000000000000000000000000000001
10000000000000111000111100000000000000000001
10000000000000100000000100000000000000000001
1000000000000010000000010000000000000000000111111111
1000000000000010000000010000000000000000000000000001
100000000000001000N000010000000000000000000111111111
10000000000000100000000100000000000000000001
10000000001000111111111100001000110000000001
10000000011000100000000100011000000000000001
10000000011000001000000010011000000000010001
10000000110000000000000000110000000000000001
10000000000000000000000001100000000000000001
10000000000000000000100001000000000000000001
10011000000000000000000000000000000000000001
11111111111111111111111111111111111111111111

