

			NO img/wall/tree_1.xpm 
SO   img/wall/10.xpm

	F 	195,158,182

WE img/wall/09.xpm

C         001,104,014

	EA img/wall/11.xpm



111111
100001
1S0001
100001
100001
111121
100001
100001
100001
100001
100001
100001
112111
100001
100001
100001
100001
100001
100001
110111
100001
100001
100001
100001
100001
100001
111121
100001
100001
100001
100001
100001
100001
111101
100001
100001
100001
100001
100001
111111