	F 	48,78,52 



C         16,36,84


			NO img/wall/08.xpm 
SO   img/wall/10.xpm


WE img/wall/09.xpm


	EA img/wall/11.xpm



         1111111111111111111111111
         1000000000110000000000001
        10010000011100000000000001
        10010000000000000200000011
1111111110110000011100000000000001
1000000000000000011121111211100001
11110111111111011100000010001000011111111111
11112111111111011101010010001000000011000101 
11000000110101011100000010001000000011100011 
10000000000000001100000010001100000000000001
10000000000000001100000000001111111111111111
11000001110101011111211110N01
11100111 1110101 101111010001  11111
11100111 1110101 101111010001  10001
11100111 1110111 101111010001  10001
11100111   111   101111010001  11001
11100111         101111010001   1001
111001           111111111111   1001
100001                          1001
100001111111111111111111111111111001
100000000000000000000000000000000001
111111111110011111112111111111111111     
        1110011111100011111111111        111111111111111111111111
        1000000000110000000000001        100000000110000010000001 
        1011000001110000000000001        1000000001110000010000001 
        1001000000000000000000001        1000000000000000000000001
111111111211000001010000010000001111111111011000111010000010000001
1000000000110000011111211111111111  100000000011000001111111111111
11110111111111111100000010001111101111010110110000000100011
1111011111111101110101000000111110111111111011001010000001
1100000011010101111000001000000000000110101011110000010001
1100000011010101111000001000000000000110101011110000010001
1100000011010101111000001000000000000110101011110000010001
1000000010000000110000010001111000000010000000100000010001
1000000000000000110101001000110000000000000001101010010001
110000011101010111111111100111000001112101011111011110011
11111111 101000000000001111111111111 1011111000000011011
1111111111011111111111011           1101111111111111101111111  
1000000000000000000000001          1000000000110000010000001    
1011000001110000000000001          111000001110000010000001   
10010000000000000000000011111111   1001000000000000000000011111111
111111111211000001010000000000001111111111011100001010000010000001
100000000011000001111101111111111100000000011000001111101111111111
11110111111111111100000010001111100111111111011100000010001
1111011111111101110101000000111112111111111011101010000001
1100000011010101111000001000111000000110101011110000010001
1100000011010101111000001000111000000110101011110000010001
1111111111111111111111111111111111111111111111111111111111

